2 1 60 60 580 580 
1 3 60 60 580 580 0 174 12 
1 3 60 60 580 580 0 354 12 
1 1 90 90 520 520 520 520 2 1 60 60 580 580 
1 1 90 90 520 520 520 520 2 1 60 60 580 580 
1 1 90 90 520 520 
2 3 89 89 522 522 2 357 140 
2 1 120 120 460 460 
1 3 119 119 462 462 -1 290 12 
1 1 150 150 400 400 
2 3 149 149 402 402 2 357 90 
2 1 180 180 340 340 
1 3 179 179 342 342 0 290 12 
1 1 210 210 280 280 
2 3 209 209 282 282 2 357 50 
2 1 240 240 220 220 
1 3 239 239 222 222 0 0 12 
1 1 270 270 160 160 
2 3 269 269 162 162 -1 357 230 
2 1 300 300 100 100 
