2 1 60 60 580 580 
1 3 60 60 580 580 0 170 20 
1 3 60 60 580 580 0 350 20 
1 1 110 110 480 480 480 480 2 1 60 60 580 580 
1 1 110 110 480 480 480 480 2 1 60 60 580 580 
1 1 110 110 480 480 
2 3 109 109 482 482 1 357 20 
2 1 160 160 380 380 
1 3 159 159 382 382 -1 160 20 
1 1 210 210 280 280 
2 3 209 209 282 282 1 357 90 
2 1 260 260 180 180 
1 3 259 259 182 182 -1 180 20 
1 1 310 310 80 80 
3 4 10 10 10 10 
