2 1 60 60 580 580 
1 3 60 60 580 580 0 176 8 
5 3 60 60 580 580 0 356 8 
5 1 80 80 540 540 540 540 1 1 60 60 580 580 
5 1 80 80 540 540 540 540 1 1 60 60 580 580 
2 1 80 80 540 540 
1 3 79 79 542 542 0 30 8 
1 1 100 100 500 500 
2 3 99 99 502 502 0 357 230 
2 1 120 120 460 460 
1 3 119 119 462 462 1 130 8 
1 1 140 140 420 420 
2 3 139 139 422 422 1 357 50 
2 1 160 160 380 380 
1 3 159 159 382 382 1 110 8 
1 1 180 180 340 340 
2 3 179 179 342 342 1 357 40 
2 1 200 200 300 300 
1 3 199 199 302 302 2 40 8 
1 1 220 220 260 260 
2 3 219 219 262 262 2 357 180 
2 1 240 240 220 220 
1 3 239 239 222 222 -1 170 8 
1 1 260 260 180 180 
2 3 259 259 182 182 2 357 230 
2 1 280 280 140 140 
1 3 279 279 142 142 2 0 8 
1 1 300 300 100 100 
3 4 0 0 10 10 
4 5 320 320 40 40 0 355 10 
4 5 335 335 10 10 0 270 4 
4 5 339 335 10 10 0 270 4 
4 5 337 335 10 10 0 270 4 
