2 1 60 60 580 580 
1 3 60 60 580 580 0 166 28 
5 3 60 60 580 580 0 346 28 
1 1 130 130 440 440 440 440 2 1 60 60 580 580 
1 1 130 130 440 440 440 440 2 1 60 60 580 580 
1 1 130 130 440 440 
2 3 129 129 442 442 -1 357 110 
2 1 200 200 300 300 
1 3 199 199 302 302 2 280 28 
1 1 270 270 160 160 
3 4 0 0 10 10 
4 5 320 320 40 40 0 355 10 
4 5 335 335 10 10 0 270 4 
4 5 339 335 10 10 0 270 4 
4 5 337 335 10 10 0 270 4 
