2 1 60 60 580 580 
1 3 60 60 580 580 0 170 20 
5 3 60 60 580 580 0 350 20 
1 1 110 110 480 480 480 480 2 1 60 60 580 580 
1 1 110 110 480 480 480 480 2 1 60 60 580 580 
1 1 110 110 480 480 
2 3 109 109 482 482 0 357 210 
2 1 160 160 380 380 
1 3 159 159 382 382 1 90 20 
1 1 210 210 280 280 
2 3 209 209 282 282 -1 357 80 
2 1 260 260 180 180 
1 3 259 259 182 182 2 290 20 
1 1 310 310 80 80 
3 4 0 0 10 10 
4 5 320 320 40 40 0 355 10 
4 5 335 335 10 10 0 270 4 
4 5 339 335 10 10 0 270 4 
4 5 337 335 10 10 0 270 4 
